XXXXXXXXXXXXXXXXXXXXXXXXXXXXXXXXXXXXXXXXXXXXXXXX
X                                              X
X                                              X
X                                              X
X Y       #      X       #      X              X
X                                              X
X              XXXXX                           X
X                                              X
X      XXXXXXXXXX       #                      X
X                                              X
X                                              X
X                                              X
X         #                                    X
X                            XXXXXXX           X
X                                              X
X       XXXXX                                  X
X                                              X
X                                 E            X
X            #                                 X
X                        XXXXXX                X
X                                              X
X               #                              X
X                                              X
X    XXXXXXXXXXXXX                             X
X    XXXXXXXXXXXXX                             X
X                                              X
X                  XXXXXX                      X
X                                              X
X                        ####                  X
X                                              X
X                                              X
X                                              X
X                                        E     X
X                                              X
X          E                                   X
XXXXXXXXXXXXXXXXXXXXXXXXXXXXXXXXXXXXXXXXXXXXXXXX